{
  "Ident": "JTM",
  "Rows": 20,
  "Columns": 30,
  "TileHeight": 32,
  "TileWidth": 64,
  "Layers":[{
    "Name":"Floor",
    "Rows":60,
    "Columns": 20,
    "Visible":true,
    "FrameDuration": 100,
    "Grid":[0, 0, 0, 0, 0, 0, 0, 1, 1, 1, 0, 0, 0, 0, 0, 0, 0, 0, 0, 1,
    0, 0, 0, 2, 1, 1, 1, 1, 1, 2, 1, 2, 2, 3, 0, 5, 1, 1, 1, 0,
    0, 0, 0, 2, 3, 1, 3, 2, 2, 1, 1, 4, 2, 4, 0, 5, 1, 1, 1, 0,
    0, 0, 0, 1, 3, 2, 4, 2, 3, 3, 2, 2, 2, 1, 0, 5, 1, 1, 1, 0,
    0, 0, 0, 1, 4, 1, 4, 2, 3, 4, 1, 36, 2, 1, 0, 5, 1, 1, 1, 0,
    0, 0, 0, 1, 1, 1, 1, 3, 4, 1, 1, 3, 2, 4, 0, 5, 1, 1, 1, 0,
    0, 0, 0, 1, 4, 3, 4, 4, 3, 1, 4, 4, 1, 2, 0, 5, 1, 1, 1, 0,
    0, 0, 0, 3, 4, 2, 1, 1, 2, 1, 1, 2, 2, 1, 0, 0, 0, 1, 1, 0,
    0, 0, 0, 2, 4, 1, 4, 1, 1, 3, 1, 3, 2, 4, 0, 0, 0, 0, 0, 0,
    0, 0, 0, 3, 1, 1, 1, 2, 1, 2, 1, 1, 1, 4, 1, 1, 3, 1, 3, 1,
    0, 0, 0, 1, 4, 3, 4, 4, 3, 1, 4, 4, 1, 1, 2, 1, 2, 1, 1, 1,
    0, 0, 0, 3, 4, 2, 1, 1, 2, 1, 1, 2, 2, 1, 1, 1, 2, 1, 1, 1,
    0, 0, 0, 2, 4, 1, 4, 1, 1, 3, 1, 3, 2, 4, 0, 0, 0, 0, 0, 1,
    0, 0, 0, 3, 1, 1, 1, 2, 1, 2, 1, 1, 3, 2, 0, 9, 6, 6, 6, 0,
    0, 0, 0, 2, 1, 1, 1, 1, 1, 2, 1, 2, 2, 3, 0, 5, 1, 1, 1, 0,
    0, 0, 0, 2, 3, 1, 3, 2, 2, 1, 1, 4, 2, 4, 0, 5, 1, 1, 1, 0,
    0, 0, 0, 1, 3, 2, 4, 2, 3, 3, 2, 2, 2, 1, 0, 5, 1, 1, 1, 0,
    0, 0, 0, 1, 4, 1, 4, 2, 3, 4, 1, 1, 2, 1, 0, 5, 1, 1, 1, 0,
    0, 0, 0, 1, 1, 1, 1, 3, 4, 1, 1, 3, 2, 4, 0, 5, 1, 1, 1, 0,
    0, 0, 0, 1, 4, 3, 4, 4, 3, 1, 4, 4, 1, 2, 0, 5, 1, 1, 1, 0,
    0, 0, 0, 6, 6, 6, 6, 6, 6, 6, 6, 6, 6, 6, 0, 5, 1, 1, 1, 0,
    0, 0, 0, 6, 6, 6, 6, 6, 6, 6, 6, 6, 6, 6, 0, 5, 1, 1, 1, 0,
    0, 0, 0, 6, 6, 6, 6, 6, 6, 6, 6, 6, 6, 6, 0, 5, 1, 1, 1, 0,
    0, 0, 0, 6, 6, 6, 6, 6, 6, 6, 6, 6, 6, 6, 0, 5, 1, 1, 1, 0,
    0, 0, 0, 2, 3, 1, 3, 2, 2, 1, 1, 4, 2, 4, 0, 5, 1, 1, 1, 0,
    0, 0, 0, 1, 3, 2, 4, 36, 36, 36, 36, 2, 2, 1, 0, 5, 1, 1, 1, 0,
    0, 0, 0, 1, 4, 1, 4, 36, 36, 36, 36, 1, 2, 1, 0, 5, 1, 1, 1, 0,
    0, 0, 0, 1, 1, 1, 1, 36, 36, 36, 36, 3, 2, 4, 0, 5, 1, 1, 1, 0,
    0, 0, 0, 1, 4, 3, 4, 36, 36, 36, 36, 4, 1, 2, 0, 5, 1, 1, 1, 0,
    0, 0, 0, 3, 4, 2, 1, 36, 36, 36, 36, 2, 2, 1, 0, 5, 1, 1, 1, 0,
    0, 0, 0, 2, 4, 1, 4, 36, 36, 36, 36, 3, 2, 4, 0, 5, 1, 1, 1, 0,
    0, 0, 0, 3, 1, 1, 1, 36, 36, 36, 36, 1, 3, 2, 0, 5, 1, 1, 1, 0,
    0, 0, 0, 2, 1, 1, 1, 36, 36, 36, 36, 2, 2, 3, 0, 5, 1, 1, 1, 0,
    0, 0, 0, 2, 3, 1, 3, 36, 36, 36, 36, 4, 2, 4, 0, 5, 1, 1, 1, 0,
    0, 0, 0, 1, 3, 2, 4, 36, 36, 36, 36, 2, 2, 1, 0, 5, 1, 1, 1, 0,
    0, 0, 0, 1, 4, 1, 4, 36, 36, 36, 36, 1, 2, 1, 0, 5, 1, 1, 1, 0,
    0, 0, 0, 1, 1, 1, 1, 36, 36, 36, 36, 3, 2, 4, 0, 5, 1, 1, 1, 0,
    0, 0, 0, 1, 4, 3, 4, 36, 36, 36, 36, 4, 1, 2, 0, 5, 1, 1, 1, 0,
    0, 0, 0, 3, 4, 2, 1, 36, 36, 36, 36, 2, 2, 1, 0, 5, 1, 1, 1, 0,
    0, 0, 0, 2, 4, 1, 4, 36, 36, 36, 36, 3, 2, 4, 0, 5, 1, 1, 1, 0,
    0, 0, 0, 3, 1, 1, 1, 36, 36, 36, 36, 1, 3, 2, 0, 5, 1, 1, 1, 0,
    0, 0, 0, 3, 4, 2, 1, 36, 36, 36, 36, 2, 2, 1, 0, 5, 1, 1, 1, 0,
    0, 0, 0, 2, 4, 1, 4, 36, 36, 36, 36, 3, 2, 4, 0, 5, 1, 1, 1, 0,
    0, 0, 0, 3, 1, 1, 1, 36, 36, 36, 36, 1, 3, 2, 0, 5, 1, 1, 1, 0,
    0, 0, 0, 3, 4, 2, 1, 36, 36, 36, 36, 2, 2, 1, 0, 5, 1, 1, 1, 0,
    0, 0, 0, 2, 4, 1, 4, 36, 36, 36, 36, 3, 2, 4, 0, 5, 1, 1, 1, 0,
    0, 0, 0, 3, 1, 1, 1, 36, 36, 36, 36, 1, 3, 2, 0, 5, 1, 1, 1, 0,
    0, 0, 0, 2, 1, 1, 1, 36, 36, 36, 36, 2, 2, 3, 0, 5, 1, 1, 1, 0,
    0, 0, 0, 2, 3, 1, 3, 2, 2, 1, 1, 4, 2, 4, 0, 5, 1, 1, 1, 0,
    0, 0, 0, 1, 3, 2, 4, 2, 3, 3, 2, 2, 2, 1, 0, 1, 1, 1, 1, 0,
    1, 4, 1, 1, 3, 1, 4, 2, 3, 4, 1, 1, 2, 4, 1, 1, 3, 1, 1, 0,
    1, 1, 2, 1, 2, 1, 1, 3, 4, 1, 1, 3, 2, 1, 2, 1, 2, 1, 1, 0,
    1, 1, 1, 2, 1, 3, 4, 4, 1, 1, 4, 4, 1, 1, 1, 2, 1, 1, 1, 0,
    1, 0, 0, 3, 4, 2, 1, 1, 2, 1, 1, 2, 2, 1, 0, 0, 2, 2, 1, 0,
    1, 0, 0, 2, 4, 1, 4, 1, 1, 3, 1, 3, 2, 4, 0, 5, 1, 2, 1, 0,
    1, 1, 0, 3, 1, 1, 1, 2, 2, 1, 1, 1, 3, 2, 0, 5, 1, 1, 1, 0,
    1, 1, 1, 0, 0, 0, 0, 2, 3, 3, 0, 0, 0, 0, 0, 5, 1, 1, 1, 0,
    1, 1, 1, 1, 1, 1, 0, 2, 3, 4, 0, 9, 6, 6, 6, 13, 1, 1, 1, 0,
    1, 1, 1, 1, 1, 1, 1, 3, 4, 1, 2, 5, 1, 1, 1, 1, 1, 1, 1, 0,
    1, 0, 0, 0, 0, 0, 0, 1, 1, 1, 1, 0, 0, 0, 0, 0, 0, 0, 0, 1]
  },{
    "Name":"Walls",
    "Rows":60,
    "Columns": 20,
    "Visible":true,
    "FrameDuration": 100,
    "Grid":[0, 0, 0, 0, 0, 0, 0, 0, 0, 0, 0, 0, 0, 0, 0, 0, 0, 0, 0, 0,
    0, 0, 0, 62, 50, 50, 92, 58, 0, 0, 59, 92, 54, 54, 63, 0, 0, 0, 0, 0,
    0, 0, 0, 49, 0, 0, 0, 0, 0, 0, 0, 0, 0, 0, 0, 0, 0, 0, 0, 0,
    0, 0, 0, 49, 0, 0, 0, 0, 0, 0, 0, 0, 0, 0, 0, 0, 0, 0, 0, 0,
    0, 0, 0, 89, 0, 0, 0, 0, 0, 0, 0, 0, 0, 0, 0, 0, 0, 0, 0, 0,
    0, 0, 0, 49, 0, 0, 0, 0, 0, 0, 0, 0, 0, 0, 0, 0, 0, 0, 0, 0,
    0, 0, 0, 49, 0, 0, 0, 0, 0, 0, 0, 0, 0, 0, 0, 0, 0, 0, 0, 0,
    0, 0, 0, 49, 0, 0, 0, 0, 0, 0, 0, 0, 0, 0, 0, 0, 0, 0, 0, 0,
    0, 0, 0, 49, 0, 0, 0, 0, 0, 0, 0, 0, 0, 0, 0, 0, 0, 0, 0, 0,
    0, 0, 0, 83, 0, 0, 0, 0, 0, 0, 0, 0, 0, 0, 0, 0, 0, 0, 0, 0,
    0, 0, 0, 0, 0, 0, 0, 0, 0, 0, 0, 0, 0, 0, 0, 0, 0, 0, 0, 0,
    0, 0, 0, 0, 0, 0, 0, 0, 0, 0, 0, 0, 0, 0, 0, 0, 0, 0, 0, 0,
    0, 0, 0, 0, 0, 0, 0, 0, 0, 0, 0, 0, 0, 0, 0, 0, 0, 0, 0, 0,
    0, 0, 0, 0, 0, 0, 0, 0, 0, 0, 0, 0, 0, 0, 0, 0, 0, 0, 0, 0,
    0, 0, 0, 0, 0, 0, 0, 0, 0, 0, 0, 0, 0, 0, 0, 0, 0, 0, 0, 0,
    0, 0, 0, 0, 0, 0, 0, 0, 0, 0, 0, 0, 0, 0, 0, 0, 0, 0, 0, 0,
    0, 0, 0, 0, 0, 0, 0, 0, 0, 0, 0, 0, 0, 0, 0, 0, 0, 0, 0, 0,
    0, 0, 0, 0, 0, 0, 0, 0, 0, 0, 0, 0, 0, 0, 0, 0, 0, 0, 0, 0,
    0, 0, 0, 0, 0, 0, 0, 0, 0, 0, 0, 0, 0, 0, 0, 0, 0, 0, 0, 0,
    0, 0, 0, 0, 0, 0, 0, 0, 0, 0, 0, 0, 0, 0, 0, 0, 0, 0, 0, 0,
    0, 0, 0, 0, 0, 0, 0, 0, 0, 0, 0, 0, 0, 0, 0, 0, 0, 0, 0, 0,
    0, 0, 0, 0, 0, 0, 0, 0, 0, 0, 0, 0, 0, 0, 0, 0, 0, 0, 0, 0,
    0, 0, 0, 0, 0, 0, 0, 0, 0, 0, 0, 0, 0, 0, 0, 0, 0, 0, 0, 0,
    0, 0, 0, 0, 0, 0, 0, 0, 0, 0, 0, 0, 0, 0, 0, 0, 0, 0, 0, 0,
    0, 0, 0, 0, 0, 0, 0, 0, 0, 0, 0, 0, 0, 0, 0, 0, 0, 0, 0, 0,
    0, 0, 0, 0, 0, 0, 0, 0, 0, 0, 0, 0, 0, 0, 0, 0, 0, 0, 0, 0,
    0, 0, 0, 0, 0, 0, 0, 0, 0, 0, 0, 0, 0, 0, 0, 0, 0, 0, 0, 0,
    0, 0, 0, 0, 0, 0, 0, 0, 0, 0, 0, 0, 0, 0, 0, 0, 0, 0, 0, 0,
    0, 0, 0, 0, 0, 0, 0, 0, 0, 0, 0, 0, 0, 0, 0, 0, 0, 0, 0, 0,
    0, 0, 0, 0, 0, 0, 0, 0, 0, 0, 0, 0, 0, 0, 0, 0, 0, 0, 0, 0,
    0, 0, 0, 0, 0, 0, 0, 0, 0, 0, 0, 0, 0, 0, 0, 0, 0, 0, 0, 0,
    0, 0, 0, 0, 0, 0, 0, 0, 0, 0, 0, 0, 0, 0, 0, 0, 0, 0, 0, 0,
    0, 0, 0, 0, 0, 0, 0, 0, 0, 0, 0, 0, 0, 0, 0, 0, 0, 0, 0, 0,
    0, 0, 0, 0, 0, 0, 0, 0, 0, 0, 0, 0, 0, 0, 0, 0, 0, 0, 0, 0,
    0, 0, 0, 0, 0, 0, 0, 0, 0, 0, 0, 0, 0, 0, 0, 0, 0, 0, 0, 0,
    0, 0, 0, 0, 0, 0, 0, 0, 0, 0, 0, 0, 0, 0, 0, 0, 0, 0, 0, 0,
    0, 0, 0, 0, 0, 0, 0, 0, 0, 0, 0, 0, 0, 0, 0, 0, 0, 0, 0, 0,
    0, 0, 0, 0, 0, 0, 0, 0, 0, 0, 0, 0, 0, 0, 0, 0, 0, 0, 0, 0,
    0, 0, 0, 0, 0, 0, 0, 0, 0, 0, 0, 0, 0, 0, 0, 0, 0, 0, 0, 0,
    0, 0, 0, 0, 0, 0, 0, 0, 0, 0, 0, 0, 0, 0, 0, 0, 0, 0, 0, 0,
    0, 0, 0, 0, 0, 0, 0, 0, 0, 0, 0, 0, 0, 0, 0, 0, 0, 0, 0, 0,
    0, 0, 0, 0, 0, 0, 0, 0, 0, 0, 0, 0, 0, 0, 0, 0, 0, 0, 0, 0,
    0, 0, 0, 0, 0, 0, 0, 0, 0, 0, 0, 0, 0, 0, 0, 0, 0, 0, 0, 0,
    0, 0, 0, 0, 0, 0, 0, 0, 0, 0, 0, 0, 0, 0, 0, 0, 0, 0, 0, 0,
    0, 0, 0, 0, 0, 0, 0, 0, 0, 0, 0, 0, 0, 0, 0, 0, 0, 0, 0, 0,
    0, 0, 0, 0, 0, 0, 0, 0, 0, 0, 0, 0, 0, 0, 0, 0, 0, 0, 0, 0,
    0, 0, 0, 0, 0, 0, 0, 0, 0, 0, 0, 0, 0, 0, 0, 0, 0, 0, 0, 0,
    0, 0, 0, 0, 0, 0, 0, 0, 0, 0, 0, 0, 0, 0, 0, 0, 0, 0, 0, 0,
    0, 0, 0, 0, 0, 0, 0, 0, 0, 0, 0, 0, 0, 0, 0, 0, 0, 0, 0, 0,
    0, 0, 0, 0, 0, 0, 0, 0, 0, 0, 0, 0, 0, 0, 0, 0, 0, 0, 0, 0,
    0, 0, 0, 0, 0, 0, 0, 0, 0, 0, 0, 0, 0, 0, 0, 0, 0, 0, 0, 0,
    0, 0, 0, 0, 0, 0, 0, 0, 0, 0, 0, 0, 0, 0, 0, 0, 0, 0, 0, 0,
    0, 0, 0, 0, 0, 0, 0, 0, 0, 0, 0, 0, 0, 0, 0, 0, 0, 0, 0, 0,
    0, 0, 0, 0, 0, 0, 0, 0, 0, 0, 0, 0, 0, 0, 0, 0, 0, 0, 0, 0,
    0, 0, 0, 0, 0, 0, 0, 0, 0, 0, 0, 0, 0, 0, 0, 0, 0, 0, 0, 0,
    0, 0, 0, 0, 0, 0, 0, 0, 0, 0, 0, 0, 0, 0, 0, 0, 0, 0, 0, 0,
    0, 0, 0, 0, 0, 0, 0, 0, 0, 0, 0, 0, 0, 0, 0, 0, 0, 0, 0, 0,
    0, 0, 0, 0, 0, 0, 0, 0, 0, 0, 0, 0, 0, 0, 0, 0, 0, 0, 0, 0,
    0, 0, 0, 0, 0, 0, 0, 0, 0, 0, 0, 0, 0, 0, 0, 0, 0, 0, 0, 0,
    0, 0, 0, 0, 0, 0, 0, 0, 0, 0, 0, 0, 0, 0, 0, 0, 0, 0, 0, 0]
  },{
    "Name":"Occluders",
    "Rows":60,
    "Columns": 20,
    "Visible":true,
    "FrameDuration": 100,
    "Grid":[0, 0, 0, 0, 0, 0, 0, 109, 0, 0, 0, 0, 0, 0, 108, 108, 108, 108, 108, 95,
    0, 0, 0, 0, 0, 0, 0, 0, 0, 0, 0, 0, 0, 0, 0, 0, 0, 0, 0, 107,
    0, 0, 0, 0, 0, 0, 0, 0, 0, 0, 0, 0, 0, 0, 55, 0, 0, 0, 0, 107,
    0, 0, 0, 0, 0, 0, 0, 0, 0, 0, 0, 0, 0, 0, 67, 0, 76, 73, 0, 107,
    0, 0, 0, 0, 0, 0, 95, 0, 0, 0, 0, 95, 0, 0, 67, 0, 75, 74, 0, 107,
    0, 0, 0, 0, 0, 0, 0, 0, 0, 0, 0, 0, 0, 0, 67, 0, 0, 0, 0, 107,
    0, 0, 0, 0, 0, 0, 0, 0, 0, 0, 0, 0, 0, 0, 67, 0, 0, 0, 0, 107,
    0, 0, 0, 0, 0, 0, 23, 0, 0, 0, 0, 21, 0, 0, 67, 0, 0, 0, 0, 107,
    0, 0, 0, 0, 0, 0, 0, 0, 0, 0, 0, 0, 0, 0, 67, 0, 0, 0, 0, 107,
    0, 0, 0, 0, 0, 0, 0, 0, 0, 0, 0, 0, 0, 0, 75, 66, 50, 88, 50, 58,
    0, 0, 0, 53, 0, 0, 96, 0, 0, 0, 0, 96, 0, 0, 0, 0, 0, 0, 0, 0,
    0, 0, 0, 87, 0, 0, 0, 0, 0, 0, 0, 0, 0, 0, 0, 0, 0, 0, 0, 0,
    0, 0, 0, 49, 0, 0, 0, 0, 0, 0, 0, 0, 0, 0, 76, 68, 68, 68, 68, 95,
    0, 0, 0, 83, 0, 0, 23, 0, 0, 0, 0, 21, 0, 0, 67, 0, 0, 0, 0, 107,
    0, 0, 0, 53, 0, 0, 0, 0, 0, 0, 0, 0, 0, 0, 67, 0, 0, 0, 0, 107,
    0, 0, 0, 49, 0, 0, 0, 0, 0, 0, 0, 0, 0, 0, 67, 0, 0, 0, 0, 107,
    0, 0, 0, 53, 0, 0, 95, 0, 0, 0, 0, 95, 0, 0, 67, 0, 21, 0, 0, 107,
    0, 0, 0, 99, 0, 0, 0, 0, 0, 0, 0, 0, 0, 0, 67, 0, 0, 0, 0, 107,
    0, 0, 0, 49, 0, 0, 0, 0, 0, 0, 0, 0, 0, 0, 67, 0, 0, 0, 0, 107,
    0, 0, 0, 49, 0, 0, 0, 0, 0, 0, 0, 0, 0, 0, 67, 0, 0, 0, 0, 107,
    0, 0, 0, 53, 0, 0, 0, 0, 0, 0, 0, 0, 0, 0, 67, 0, 0, 0, 0, 107,
    0, 0, 0, 87, 60, 52, 52, 57, 0, 0, 60, 52, 52, 57, 67, 0, 21, 0, 0, 107,
    0, 0, 0, 49, 59, 90, 84, 58, 0, 0, 59, 84, 90, 58, 67, 0, 0, 0, 0, 107,
    0, 0, 0, 49, 0, 0, 0, 0, 0, 0, 0, 0, 0, 0, 67, 0, 0, 0, 0, 107,
    0, 0, 0, 53, 37, 0, 0, 0, 0, 0, 0, 0, 0, 0, 67, 0, 0, 0, 0, 107,
    0, 0, 0, 53, 37, 0, 0, 0, 0, 0, 0, 0, 0, 0, 67, 0, 0, 0, 0, 107,
    0, 0, 0, 49, 0, 0, 0, 0, 0, 0, 0, 0, 0, 0, 67, 0, 21, 0, 0, 107,
    0, 0, 0, 81, 0, 0, 0, 0, 0, 0, 0, 0, 0, 0, 67, 0, 0, 0, 0, 107,
    0, 0, 0, 93, 0, 0, 0, 0, 0, 0, 0, 0, 0, 76, 80, 0, 0, 0, 0, 107,
    0, 0, 0, 99, 0, 0, 0, 0, 0, 0, 0, 0, 0, 75, 79, 0, 0, 0, 0, 107,
    0, 0, 0, 93, 0, 0, 0, 0, 0, 0, 0, 0, 0, 0, 67, 0, 0, 0, 0, 107,
    0, 0, 0, 87, 0, 0, 0, 0, 0, 0, 0, 0, 0, 0, 67, 0, 21, 0, 0, 107,
    0, 0, 0, 53, 0, 0, 57, 0, 0, 0, 0, 0, 0, 0, 67, 0, 0, 0, 0, 107,
    0, 0, 0, 62, 90, 84, 58, 0, 0, 0, 59, 84, 90, 58, 80, 0, 0, 0, 0, 107,
    0, 0, 0, 83, 0, 0, 0, 0, 0, 0, 0, 0, 0, 0, 67, 0, 0, 0, 0, 107,
    0, 0, 0, 93, 0, 0, 0, 0, 0, 0, 0, 0, 0, 0, 67, 0, 0, 0, 0, 107,
    0, 0, 0, 87, 41, 42, 0, 0, 0, 0, 0, 0, 43, 44, 67, 0, 21, 0, 0, 107,
    0, 0, 0, 49, 0, 0, 0, 0, 0, 0, 0, 0, 0, 0, 67, 0, 0, 0, 0, 107,
    0, 0, 0, 61, 57, 0, 0, 0, 0, 0, 0, 0, 0, 76, 80, 0, 0, 0, 0, 107,
    0, 0, 0, 62, 58, 0, 0, 0, 0, 0, 0, 0, 0, 75, 79, 0, 0, 0, 0, 107,
    0, 0, 0, 49, 0, 0, 0, 0, 0, 0, 0, 0, 0, 0, 67, 0, 0, 0, 0, 107,
    0, 0, 0, 87, 41, 42, 0, 0, 0, 0, 0, 0, 43, 44, 67, 0, 21, 0, 0, 107,
    0, 0, 0, 53, 0, 0, 0, 0, 0, 0, 0, 0, 0, 0, 67, 0, 0, 0, 0, 107,
    0, 0, 0, 61, 57, 0, 0, 0, 0, 0, 0, 0, 0, 76, 80, 0, 0, 0, 0, 107,
    0, 0, 0, 62, 58, 0, 0, 0, 0, 0, 0, 0, 0, 75, 79, 0, 0, 0, 0, 107,
    0, 0, 0, 93, 0, 0, 0, 0, 0, 0, 0, 0, 0, 0, 67, 0, 0, 0, 0, 107,
    0, 0, 0, 87, 41, 42, 0, 0, 0, 0, 0, 0, 43, 44, 67, 0, 21, 0, 0, 107,
    0, 0, 0, 93, 0, 0, 0, 0, 0, 0, 0, 0, 0, 0, 67, 0, 0, 0, 0, 107,
    0, 0, 0, 61, 57, 0, 0, 0, 0, 0, 0, 0, 0, 76, 80, 0, 0, 0, 0, 107,
    0, 0, 0, 62, 58, 0, 0, 0, 0, 0, 0, 0, 0, 75, 79, 0, 0, 0, 0, 107,
    59, 50, 82, 58, 0, 0, 0, 0, 0, 0, 0, 0, 0, 0, 75, 66, 58, 0, 0, 107,
    0, 0, 0, 0, 0, 0, 0, 0, 23, 21, 0, 0, 0, 0, 0, 0, 0, 0, 0, 107,
    0, 0, 0, 0, 0, 0, 0, 0, 0, 0, 0, 0, 0, 0, 0, 0, 0, 0, 0, 107,
    107, 68, 68, 73, 0, 0, 0, 0, 0, 0, 0, 0, 0, 0, 76, 68, 68, 0, 0, 107,
    107, 0, 0, 65, 0, 0, 0, 0, 0, 0, 0, 0, 0, 0, 67, 0, 0, 0, 0, 107,
    107, 0, 0, 49, 0, 0, 0, 0, 0, 0, 0, 0, 0, 0, 67, 0, 0, 0, 0, 107,
    107, 0, 0, 61, 56, 68, 68, 73, 0, 0, 76, 68, 68, 68, 80, 0, 0, 0, 0, 107,
    107, 0, 0, 0, 0, 0, 0, 65, 0, 0, 67, 0, 0, 0, 0, 0, 0, 0, 0, 107,
    107, 0, 0, 0, 0, 0, 0, 53, 0, 0, 67, 0, 0, 0, 0, 0, 0, 0, 0, 107,
    95, 108, 108, 108, 108, 108, 108, 58, 0, 0, 95, 108, 108, 108, 108, 108, 108, 108, 108, 95]
  },{
    "Name":"Collisions",
    "Rows":60,
    "Columns": 20,
    "Visible":false,
    "FrameDuration": 100,
    "Grid":[0, 0, 0, 0, 0, 0, 0, 0, 1, 1, 0, 0, 0, 0, 1, 0, 0, 0, 0, 0,
    0, 0, 0, 1, 1, 1, 1, 1, 0, 0, 1, 1, 1, 1, 1, 0, 0, 0, 0, 0,
    0, 0, 0, 1, 0, 0, 0, 0, 0, 0, 0, 0, 0, 0, 1, 0, 0, 0, 0, 0,
    0, 0, 0, 1, 0, 0, 0, 0, 0, 0, 0, 0, 0, 0, 1, 0, 0, 0, 0, 0,
    0, 0, 0, 1, 0, 0, 1, 0, 0, 0, 0, 1, 0, 0, 1, 0, 0, 0, 0, 0,
    0, 0, 0, 1, 0, 0, 0, 0, 0, 0, 0, 0, 0, 0, 1, 0, 0, 0, 0, 0,
    0, 0, 0, 1, 0, 0, 0, 0, 0, 0, 0, 0, 0, 0, 1, 0, 0, 0, 0, 0,
    0, 0, 0, 1, 0, 0, 1, 0, 0, 0, 0, 1, 0, 0, 1, 0, 0, 0, 0, 0,
    0, 0, 0, 1, 0, 0, 0, 0, 0, 0, 0, 0, 0, 0, 1, 0, 0, 0, 0, 0,
    0, 0, 0, 1, 1, 1, 1, 1, 1, 1, 1, 1, 1, 1, 1, 1, 1, 1, 1, 1,
    0, 0, 0, 0, 0, 0, 0, 0, 0, 0, 0, 0, 0, 0, 0, 0, 0, 0, 0, 0,
    0, 0, 0, 0, 0, 0, 0, 0, 0, 0, 0, 0, 0, 0, 0, 0, 0, 0, 0, 0,
    0, 0, 0, 0, 0, 0, 0, 0, 0, 0, 0, 0, 0, 0, 0, 0, 0, 0, 0, 0,
    0, 0, 0, 0, 0, 0, 0, 0, 0, 0, 0, 0, 0, 0, 0, 0, 0, 0, 0, 0,
    0, 0, 0, 0, 0, 0, 0, 0, 0, 0, 0, 0, 0, 0, 0, 0, 0, 0, 0, 0,
    0, 0, 0, 0, 0, 0, 0, 0, 0, 0, 0, 0, 0, 0, 0, 0, 0, 0, 0, 0,
    0, 0, 0, 0, 0, 0, 0, 0, 0, 0, 0, 0, 0, 0, 0, 0, 0, 0, 0, 0,
    0, 0, 0, 0, 0, 0, 0, 0, 0, 0, 0, 0, 0, 0, 0, 0, 0, 0, 0, 0,
    0, 0, 0, 0, 0, 0, 0, 0, 0, 0, 0, 0, 0, 0, 0, 0, 0, 0, 0, 0,
    0, 0, 0, 0, 0, 0, 0, 0, 0, 0, 0, 0, 0, 0, 0, 0, 0, 0, 0, 0,
    0, 0, 0, 0, 0, 0, 0, 0, 0, 0, 0, 0, 0, 0, 0, 0, 0, 0, 0, 0,
    0, 0, 0, 0, 0, 0, 0, 0, 0, 0, 0, 0, 0, 0, 0, 0, 0, 0, 0, 0,
    0, 0, 0, 0, 0, 0, 0, 0, 0, 0, 0, 0, 0, 0, 0, 0, 0, 0, 0, 0,
    0, 0, 0, 0, 0, 0, 0, 0, 0, 0, 0, 0, 0, 0, 0, 0, 0, 0, 0, 0,
    0, 0, 0, 0, 0, 0, 0, 0, 0, 0, 0, 0, 0, 0, 0, 0, 0, 0, 0, 0,
    0, 0, 0, 0, 0, 0, 0, 0, 0, 0, 0, 0, 0, 0, 0, 0, 0, 0, 0, 0,
    0, 0, 0, 0, 0, 0, 0, 0, 0, 0, 0, 0, 0, 0, 0, 0, 0, 0, 0, 0,
    0, 0, 0, 0, 0, 0, 0, 0, 0, 0, 0, 0, 0, 0, 0, 0, 0, 0, 0, 0,
    0, 0, 0, 0, 0, 0, 0, 0, 0, 0, 0, 0, 0, 0, 0, 0, 0, 0, 0, 0,
    0, 0, 0, 0, 0, 0, 0, 0, 0, 0, 0, 0, 0, 0, 0, 0, 0, 0, 0, 0,
    0, 0, 0, 0, 0, 0, 0, 0, 0, 0, 0, 0, 0, 0, 0, 0, 0, 0, 0, 0,
    0, 0, 0, 0, 0, 0, 0, 0, 0, 0, 0, 0, 0, 0, 0, 0, 0, 0, 0, 0,
    0, 0, 0, 0, 0, 0, 0, 0, 0, 0, 0, 0, 0, 0, 0, 0, 0, 0, 0, 0,
    0, 0, 0, 0, 0, 0, 0, 0, 0, 0, 0, 0, 0, 0, 0, 0, 0, 0, 0, 0,
    0, 0, 0, 0, 0, 0, 0, 0, 0, 0, 0, 0, 0, 0, 0, 0, 0, 0, 0, 0,
    0, 0, 0, 0, 0, 0, 0, 0, 0, 0, 0, 0, 0, 0, 0, 0, 0, 0, 0, 0,
    0, 0, 0, 0, 0, 0, 0, 0, 0, 0, 0, 0, 0, 0, 0, 0, 0, 0, 0, 0,
    0, 0, 0, 0, 0, 0, 0, 0, 0, 0, 0, 0, 0, 0, 0, 0, 0, 0, 0, 0,
    0, 0, 0, 0, 0, 0, 0, 0, 0, 0, 0, 0, 0, 0, 0, 0, 0, 0, 0, 0,
    0, 0, 0, 0, 0, 0, 0, 0, 0, 0, 0, 0, 0, 0, 0, 0, 0, 0, 0, 0,
    0, 0, 0, 0, 0, 0, 0, 0, 0, 0, 0, 0, 0, 0, 0, 0, 0, 0, 0, 0,
    0, 0, 0, 0, 0, 0, 0, 0, 0, 0, 0, 0, 0, 0, 0, 0, 0, 0, 0, 0,
    0, 0, 0, 0, 0, 0, 0, 0, 0, 0, 0, 0, 0, 0, 0, 0, 0, 0, 0, 0,
    0, 0, 0, 0, 0, 0, 0, 0, 0, 0, 0, 0, 0, 0, 0, 0, 0, 0, 0, 0,
    0, 0, 0, 0, 0, 0, 0, 0, 0, 0, 0, 0, 0, 0, 0, 0, 0, 0, 0, 0,
    0, 0, 0, 0, 0, 0, 0, 0, 0, 0, 0, 0, 0, 0, 0, 0, 0, 0, 0, 0,
    0, 0, 0, 0, 0, 0, 0, 0, 0, 0, 0, 0, 0, 0, 0, 0, 0, 0, 0, 0,
    0, 0, 0, 0, 0, 0, 0, 0, 0, 0, 0, 0, 0, 0, 0, 0, 0, 0, 0, 0,
    0, 0, 0, 0, 0, 0, 0, 0, 0, 0, 0, 0, 0, 0, 0, 0, 0, 0, 0, 0,
    0, 0, 0, 0, 0, 0, 0, 0, 0, 0, 0, 0, 0, 0, 0, 0, 0, 0, 0, 0,
    0, 0, 0, 0, 0, 0, 0, 0, 0, 0, 0, 0, 0, 0, 0, 0, 0, 0, 0, 0,
    0, 0, 0, 0, 0, 0, 0, 0, 0, 0, 0, 0, 0, 0, 0, 0, 0, 0, 0, 0,
    0, 0, 0, 0, 0, 0, 0, 0, 0, 0, 0, 0, 0, 0, 0, 0, 0, 0, 0, 0,
    0, 0, 0, 0, 0, 0, 0, 0, 0, 0, 0, 0, 0, 0, 0, 0, 0, 0, 0, 0,
    0, 0, 0, 0, 0, 0, 0, 0, 0, 0, 0, 0, 0, 0, 0, 0, 0, 0, 0, 0,
    0, 0, 0, 0, 0, 0, 0, 0, 0, 0, 0, 0, 0, 0, 0, 0, 0, 0, 0, 0,
    0, 0, 0, 0, 0, 0, 0, 0, 0, 0, 0, 0, 0, 0, 0, 0, 0, 0, 0, 0,
    0, 0, 0, 0, 0, 0, 0, 0, 0, 0, 0, 0, 0, 0, 0, 0, 0, 0, 0, 0,
    0, 0, 0, 0, 0, 0, 0, 0, 0, 0, 0, 0, 0, 0, 0, 0, 0, 0, 0, 0,
    0, 0, 0, 0, 0, 0, 0, 0, 0, 0, 0, 0, 0, 0, 0, 0, 0, 0, 0, 0]
  }],
  "Tileset":{
    "Columns":16,
    "TileHeight":128,
    "TileWidth":64,
    "TextureFile":"./templates/tilemap-iso/tileset.png",
    "Animations": {}
  }
}